11 15
###############
#.....a.......#
#.....A.....A.#
#...........a.#
#.............#
#..#######.##.#
#..@..Aa......#
#..........A..#
#.............#
#.........a...#
###############
